██████████████████████████████████████████████████████████████████████
██  ██  ██  ██  ██  ██  ██  ██  ██  ██  ██  ██  ██  ██  ██  ██  ██  ██
██  ██  ██  ██  ██          ██          ██      ██              ██  ██
██  ██  ██  ██  ██  ██████████  ██  ██████████  ██████  ██  ██████  ██
██      ██      ██      ██      ██  ██      ██  ██      ██  ██      ██
██████  ██████  ██████  ██  ██  ██████████  ██  ██████  ██████  ██████
██                          ██          ██      ██      ██          ██
██████████████████  ██████  ██████████████████  ██████  ██████  ██████
██      ██          ██  ██  ██  ██      ██  ██      ██  ██      ██  ██
██  ██  ██  ██████  ██  ██  ██  ██  ██████  ██  ██████  ██  ██████  ██
██  ██  ██  ██      ██  ██  ██          ██                          ██
██  ██████████████████  ██  ██████  ██████████████  ██████  ██████████
██  ██  ██  ██  ██          ██              ██      ██              ██
██  ██  ██  ██  ██████████  ██  ██  ██████████  ██████████████  ██  ██
██              ██              ██  ██  ██          ██  ██      ██  ██
██  ██████  ██  ██████████  ██  ██████  ██  ██████████  ██████████  ██
    ██  ██  ██              ██      ██              ██      ██      ██
██  ██  ██████  ██████  ██████  ██████  ██████  ██████  ██████████████
██  ██          ██      ██                  ██                  ██  ██
██████  ██  ██  ██████  ██████  ██████  ██████  ██  ██  ██████████  ██
██      ██  ██  ██          ██      ██  ██      ██  ██                
██  ██  ██████  ██████████  ██████  ██████████  ██  ██  ██  ██████████
██  ██  ██  ██  ██  ██      ██  ██      ██      ██  ██  ██      ██  ██
██████████  ██  ██  ██████████  ██  ██████  ██████████  ██████████  ██
██                  ██                  ██      ██                  ██
██  ██  ██  ██████  ██  ██  ██████  ██████████  ██████  ██████  ██████
██  ██  ██  ██      ██  ██  ██          ██  ██      ██      ██      ██
██████  ██████  ██  ██████  ██████  ██████  ██████████████████████  ██
██      ██  ██  ██      ██  ██                  ██              ██  ██
██  ██  ██  ██████  ██████████████  ██  ██████  ██  ██████  ██████████
██  ██      ██      ██  ██          ██  ██  ██      ██      ██  ██  ██
██████  ██████████  ██  ██████████  ██████  ██  ██████████  ██  ██  ██
██          ██          ██              ██              ██          ██
██  ██  ██  ██  ██  ██  ██  ██  ██  ██  ██  ██  ██  ██  ██  ██  ██  ██
██████████████████████████████████████████████████████████████████████
